--#####-------#####-
-#     #---###  X  #
--#  X ####        #
--#    #         ###
--###          ##  E
-#           ##   #-
#######       X  #--
#    X         ##---
-#####  #######-----
------#S------------