-------------------------------------------------
--------#############----------------------------
-------#             ###-------------------------
------#        @        #------------------------
------#                 #------------------------
-------#               #-------------------------
--------##           ##--------------------------
----------##       ##----------------------------
-----------#       #-----------------------------
-----######         ####-------------------------
----#                   #####--------------------
---#                         #--###----######----
--#                          ###   ####      #---
-#                                            #--
--#                          ###  ####        #--
--#                          #-#  #---#      #---
---#                         #--# #----######----
---#                         #--# ##-------------
---#                         #--#   #------------
---#                         #--#   #------------
--#                          #---###-------------
--#                         #--------------------
--#                       ##---------------------
--#                  #####-----------------------
--#               ###----------------------------
---#            ##---------#######---------------
--- #             #########       #--------------
-----###                           #-------------
--------###############           #--------------
-----------------------###########---------------